C 255,255,255
WE ./test_map/texture/new_dot/West.xpm
NO ./test_map/texture/new_dot/North.xpm
F 255,255,255
SO ./test_map/texture/new_dot/South.xpm
EA ./test_map/texture/new_dot/East.xpm
11111
10a01
10N01
10001
11111
