

NO ./test_map/texture/new_dot/North.xpm


WE ./test_map/texture/new_dot/West.xpm


F 255,255,255


SO ./test_map/texture/new_dot/South.xpm


EA ./test_map/texture/new_dot/East.xpm


C 255,255,255


1111
10001
10N01
10001
11111
