
SO ./test_map/texture/new_dot/South.xpm
C 255,255,255

WE ./test_map/texture/new_dot/West.xpm
F 255,255,255

EA ./test_map/texture/new_dot/East.xpm
NO ./test_map/texture/new_dot/North.xpm

11111
100 1
10N01
10001
11111
