
C 255,255,255

WE ./test_map/texture/new_dot/West.xpm
EA ./test_map/texture/new_dot/East.xpm
SO ./test_map/texture/new_dot/South.xpm
F 255,255,255
NO ./test_map/texture/new_dot/North.xpm

11111
10001
10N 1
10001
11111
