C 255,255,255
NO ./test_map/texture/new_dot/North.xpm
F 255,255,255
SO ./test_map/texture/new_dot/South.xpm

WE ./test_map/texture/new_dot/West.xpm
EA ./test_map/texture/new_dot/East.xpm
11111
10001
10N01
100a1
11111
