
C 255,255,255
F 255,255,255

EA ./test_map/texture/new_dot/East.xpm
WE ./test_map/texture/new_dot/West.xpm
SO ./test_map/texture/new_dot/South.xpm
NO ./test_map/texture/new_dot/North.xpm

11111
10001
10N01
100 1
11111
