NO ./test_map/texture/new_dot/North.xpm
SO ./test_map/texture/new_dot/South.xpm
WE ./test_map/texture/new_dot/West.xpm
EA ./test_map/texture/new_dot/East.xpm
F 255,255,255
C 255,255,255
11111 
10001 
10N00 
10001 
11111 
