NOO ./test_map/texture/new_dot/North.xpm
SOO ./test_map/texture/new_dot/South.xpm
WEE ./test_map/texture/new_dot/West.xpm
EAA ./test_map/texture/new_dot/East.xpm
FF 255,255,255
CC 255,255,255
11111
10001
10N01
10001
11111
