NO ./test_map/texture/new_dot/North.xpm
SO ./test_map/texture/new_dot/South.xpm
WE ./test_map/texture/new_dot/West.xpm
EA ./test_map/texture/new_dot/East.xpm

F 0,0,0
C 0,0,0

       111111       
     1110000111     
   11100000000111   
  1100000000000011  
  1000000000000001  
 110000000000000011 
 100000000000000001 
11000000000000000011
10000000000000000001
10000000000000000001
10000N00000000000001
10000000000000000001
11000000000000000011
 100000000000000001 
 110000000000000011 
  1000000000000001  
  1100000000000011  
   11100000000111   
     1110000111     
       111111       
