SO ./test_map/texture/new_dot/South.xpm

F 0,0,0
C 0,0,0
NO ./test_map/texture/new_dot/North.xpm
WE ./test_map/texture/new_dot/West.xpm
EA ./test_map/texture/new_dot/East.xpm

11111111111111111111111
10001100001000010000001
10000100000000010000001
10000000001000000000001
11000010000000001010001
11010000101101000010001
10000000001000000000001
10000100000000010000001
10001000001000100000001
11111100000000111110001
10000000000000010000001
10001000000000000001001
10100000000100000000001
10000100000000000100001
11000000000000000000001
10000000000100000000011
10000000000000000000001
10000000N00000000000001
10000000000000000000001
10010000000000000001001
10000000000111000000011
11111111111111111111111
