NO ./test_map/texture/new_dot/North.xpm
SO ./test_map/texture/new_dot/South.xpm
WE ./test_map/texture/new_dot/West.xpm
EA ./test_map/texture/new_dot/East.xpm

F 0,0,0
C 0,0,0

       111111       
     1110000111     
   1110000000011   
  110000000000011   
  10000000000011    
 11000000000011     
 1000000000011      
1100000000011       
100000000011        
10000000011         
10000N00011         
100000000011        
1100000000011       
 1000000000011      
 11000000000011     
  10000000000011    
  110000000000011  
   1110000000011   
     1110000111     
       111111       
